1111111111111111111111111111111111
1111100011011111111111111111111111
1111101011011111111111111111111111
111110001101111S000000000000000CE1
1111111111111111111111111111111111