1111111111111
1001000000001
1000011111001
100011P000001
1111111111111